##############################################################################
#------------------#-------------------------------------#-------------------#
#------------------#-----------------#-------------------#-------------------#
#------------R-----#-----------------#---------###########----R--------------#
#------------------#-----------------#---------#-----------------------------#
#############-######-----------------#---------#---------#-------------------#
#------------------#################-#---------#---------#-------------------#
#------------------#-----------------#---------#---------#-------------------#
#------------------#-----------------#---------#---------#-------------------#
################-###-----------------#---------#---------#-------------------#
#------------------#-----------------#-------------------#-------------------#
#------------------#-----------------###-###################################-#
#------------------#-----------------#---------------------------------------#
#------------------------------------#---------------------------------------#
######################################---------------------------------------#
#-----------------------------------##---------------------------------------#
#-----------------------------------##---------------------------------------#
#------------T-----------------------#---------------------------------------#
#------------------------------------#---------------------------------------#
#------------------------------------#---------------------------------------#
#------------------------####################--------------------------------#
#------------------------------------#---------------------#-#################
#------------------------------------#---------------------#-----------------#
#---------###############------------#-----------------#####################-#
#---------#---T---------#------------#-----------------#---------------------#
#---------###############------------#-----------------#-#####################
#------------------------------------#-----------------#---------------------#
#------------------------------------#-----------------#---------------------#
#----------------------------------R-#-----------------#---------------------#
#------------------------------------#-----------------#---------------R-----#
#----------------------------T-------------------------#---------------------#
##############################################################################
