##############################################################################
#------------------#--------------------------------------------------------#
#------------------#---------------------------------------------------------#
#------------R-----#------------------------------------------R--------------#
#------------------#---------------------------------------------------------#
#############-######---------------------------------------------------#
#------------------#---------------------------------------------------------#
#------------------#---------------------------------------------------------#
#------------------#--------------------------------------------------------#
################-###----------------------------------------------------------#
#----------------------------------------------------------------------------#
#----------------------------------------------------------------------------#
#------------------------####################-------------------------------#
#----------------------------------------------------------#####-------------#
#----------------------------------------------------------#R-T#-------------#
#---------################---------------------------------#####------------#
#---------#R-------------#--------------------------------------------------#
#---------##############T#-----------------------------#-#####################
#----------------------###-----------------------------#---------------------#
#------------------------------------------------------#---------------------#
#------------------------------------------------------#---------------------#
#-----------------------------------------------------##---------------R-----#
#---------------------------------------------------T--#---------------------#
##############################################################################
