##############################################################################
#------------------#---------------------------------------------------------#
#------------------#---------------------------------------------------------#
#------------R-----#------------------------------------------R--------------#
#------------------#---------------------------------------------------------#
#############-######----------------------------T-----------------------#
#------------------#---------------------------------------------------------#
#------------------#---------------------------------------------------------#
#------------------#--------------------------------------------------------#
################-###----------------------------------------------------------#
#----------------------------------------------------------------------------#
#----------------------------------------------------------------------------#
#------------------------####################-------------------------------#
#---------------T------------------------------------------#####-------------#
#----------------------------------------------------------#R-T#-------------#
#---------################---------------------------------#####------------#
#---------#R-------------#---------------------------------------------------#
#---------##############T#---------------------------------------------------#
#----------------------###---------------------------------------------------#
#----------------------------------------------------------------------------#
#----------------------------------------------------------------------------#
#----------------------------------------------------------------------------#
#----------------------------------------------------------------------------#
##############################################################################
